first	last
aneta	michniak
jennifer	smart
vÄ—Ã«_Å›mÃ¥Ã®Ä¼
jac	jac
neelam	heera	ğŸ’›ğŸ—ğŸ’š
trudy	berger
sawyer	a	britton
annisa	afifah
sls	at	corpus	christi
teresa	alarcos	tamay
bongza	Â®ğŸ‡¿ğŸ‡¦
alice	james
å·´å±±å¤œé›¨æ¶¨ç§‹æ± 
rachel
shirly	wu
reza
grace	audu
ğŸŒ¹nina	stranger	babe
emm_sr
mnmatthews
michelle	aquino
freesocialgamesuk
lÃªÃªlÃ£ğŸ˜	bÃ£byğŸ˜˜
l			âš½			Â®			e			n
manshika
rochelle	barker
holidays	and	happilyeverafters
davlyn
mino
wednesday	addams
âš¡ï¸mikasa	ackermanâš¡ï¸
soolobee
tero	kalsta
paige	carter	âš¡
anuradha
emam
l	nov
evan	morgenstern
(((sarah	fader)))
cheryl	allen
chloe	jackson
molly	pine
susan	buchanan
cherrywm
lucia
sizzling	doe
juliana
natalia	mÃ©ndez	ordÃ³Ã±ez
@farooque	allah
maddie-jo
that	fearless	girl
debbie	mcalpine
jiu	chang
kuhluka	movement
rebecca	louiseğŸŒº
seung	kim
netball	westmidlands
mandy	stonier
â¤
haleh_abedy
alyssa
anasua	banik
wajid	ali	sangrasi	ğŸ”¥
emma	watson	official
a	b	d	u	l	m	j	i	d	âœ’ï¸
Ï€ÏÎ¹Î³ÎºÎ¹Ï€Î¹ÏƒÏƒÎ±	ğŸ‘‘ğŸŒ·
agillis
kenza	hr
mohd	hafis	mustapa
bones3217
chaste	inegbedion	iwd2018
louise	southgate
bilal	hassan
aina	orosun	ğŸ‘‘
omida	(omeeda)
monee	felix
ğŸ§ ğ”¾ğ•„â„™â€¢ğ•–ğ•Ÿğ•¥ğŸ¦‹ğŸ’™ğŸ’ğŸŒ¬ğŸ›¸
anda	chiu
ekankar	kaur
jessica	liberatore
amadrinks
misswhitney
defne
nouran	bedeir
anni
katie	lutz
chiran	regmi
dignity	drive
rozelle	roman
follow	me	help	and		fane	anjoe
tsholofelo
jason	keane
amy	askew
pretty	sambo
ultra	legend
saadia
shelley
merseyside	endometriosis	support	group
print	it	za
rachelm02188466
